.........................................
.........................................
.........................................
.........................................
.........................................
.....*******************************.....
.....*.............................*.....
.....*.............................*.....
.....*.............................*.....
.....*.............................*.....
.....*.............................*.....
.....*......../#########\..........*.....
.....*....../############\.........*.....
.....*...../###.......#####........*.....
.....*.....##...........###........*.....
.....*.....##\..........##\........*.....
.....*.....####..........##........*.....
.....*.....####........###.........*.....
.....*.....###..........##\........*.....
.....*.....###..........###........*.....
.....*.....##...........##.........*.....
.....*.....##...........##.........*.....
.....*.....#####@########..........*.....
.....*.....#############...........*.....
.....*.............................*.....
.....*.............................*.....
.....*.............................*.....
.....*.............................*.....
.....*******************************.....
.........................................
.........................................
.........................................
.........................................
.........................................